...............
.|}{..|}{..|}{.
.?$#**#$#**#$;.
.[#=.."#=.."#].
..*....*....*..
..*....*....*..
.|#%../#%../#{.
.?$#**#!#**#$;.
.[#=.."#=.."#].
..*....*....*..
..*....*....*..
./#%../#%../#{.
.(@#**#$#**#$;.
.",=..[:]..[:].
...............